[  i  ] Launching level generator
[  i  ] Starting generating room
[  i  ] Console buffer might be too small to write floors correctly.
[  i  ] ********************************
[  i  ]                             CC                                                                                                                                                                          
[  i  ]                           CC                    CCCC                                                                                        MMMM                                                        
[  i  ]             GGGGGG    CC                            CC                                                                                                                                          CC      
[  i  ]             GG        GG  GG          GGGG                                                                                                  SS  SSSS                                                    
[  i  ]                                     GG  GG                                  MM                                                              SS  SS            MM  MMMMMM                                
[  i  ]                               GG        GG                                MMMMMM          CC                                                  SSSS            MMMM  MM                                  
[  i  ]                       GG                                              MMMMMMMM              CC                                                                  MM    MM                                
[  i  ]                 GGGG            GGGG  GG                                                                                                                                                                
[  i  ]                         GG                                                              CCCC                                  CCCC  CC                                                                  
[  i  ]         CCCC                                                                            CC                                      CC              MM  MM                                                  
[  i  ]   CC    CC                                                                                        MMMM    MM                CCCC  CC  GG                            CC                                  
[  i  ]                                                                                                   MM      MM                          GG                        CCCC  MM                                
[  i  ]     CC                                                                                          CC  CCMM  MM                SS      GGGG                          CCMM                                  
[  i  ]         CC                            GG                                        MM              CCCCCC                                                                MM                                
[  i  ]                                       GGGGGG                                                                                                                                                            
[  i  ]     CC      CCCC                      GG  GG                                                                                                                                                            
[  i  ]             CC                  GG        GG                                                                    CC        GG                                                                            
[  i  ]       CC    CCCC            MMMMGG      GGGG                            MM                                  CCCCCC            GG                                GG                                      
[  i  ]     CCCC        CC                                                    MM  MM  MM                              CCMM    MM      GG                                  GG                  MM                
[  i  ]     CC  CC      SSSS                                                          MM                                CC                                            GGGG  GG                MM                
[  i  ] CCCC              SSSS        CCCC    CC        MM                        MM                                CC  CC    MMMM                SS                                                            
[  i  ]         CC          SS      MM  CC        MM        SS                MM    MM                                                                                                                          
[  i  ]   CCCCCC                        CCCCCCCCMMMMMM  MM                CC          MM                          SS  SS  SS                                                                                    
[  i  ]                                         MM      MM          CC  CC          MM  MM                        SS    SS      GG    GGGG                                          GGGG                        
[  i  ]                                         SS                  CC  CCCC                          GG  GG                            GG                                    SSSSSSSS                          
[  i  ]                         SSSSSS                SS              CC  CC                        GG  GGGG                          GG                                      SS  SS      GG                    
[  i  ]                     SS  SSMMMM                              CC    CC  MM  MM    MM            GGGGGG                                                                        SS                    CC    
[  i  ]     GGSS                  SS  MM                                        MMMM  MM                                                                      SSSS                                              
[  i  ]   CCGG                SS    MM                                        MM      MM            GGGGGGGGGG                    GGGG                  SSSSSS                                                  
[  i  ]   GGCCCC  CC          SSSS                                                                                                  GGGG                GG  SSGGSS                                              
[  i  ]           CC                                                              MM  MMMM                                        GGGG    GG              SSSSGGSS                                      GGGG    
[  i  ]                                                       CC                      MMMM                                        GGGGGGGGGG              SSSSGG                                      GG        
[  i  ]                                                                           MMMM    MM                    MM  MM            GG      CC                                                          GGGGGG    
[  i  ]         CC                  MMMM                  CC    CC                                                                        CC  CC                                                    CCGGGGGG    
[  i  ]   CC    CC                    MM                          CC                                                                        CC                            MMMMMM                    GGCCMM      
[  i  ] CCCCCCCCCC                                      SSSSCC  CC                CC                            MMMM                        CC                                  MM                  CCCCCC      
[  i  ]                                                   SS                                                                GGGG          CC  CC                                                                
[  i  ]                                         MM  MM  SSSSSS  SS                                                        GGGG                                                                        CCCC      
[  i  ]                                         MM      SS  SS  SS                                  CC                                                                                                          
[  i  ]                                           MMMM  SSSS                                            CC                GG                                                                                    
[  i  ]                                   GG            SS                                              CC                                                                                                      
[  i  ]                                                                                                                                                                                                         
[  i  ]                                   GG                                                                                                                            MM    MM                                
[  i  ]                                                                                                                                                                 MM    MM                                
[  i  ]                                                                                                                                                                     SS  SS                              
[  i  ]                                                           GGGG  GG                                                                        MM    MM                                    CC                
[  i  ]                                                                                           MM                                                                              SS        CCCC    GG          
[  i  ]                                                           GG    GG                                                                                                                        GG    GG      
[  i  ]                                                           GGGGGG    MM    MM  MM                                    MM                                                                        GGGG    CC
[  i  ]                                                         GGGGGG  GGMMMMMMMMMMMM                                      MM                                                                          GG  GGGG
[  i  ]         GG                              CCCC                      MM  MM    MM                                      MM                                          MMMM                                CC  
[  i  ]               SSSS                        CCCC                                                                    MMMM                                        MM                CCCC        SS  SS  GGCC
[  i  ]                                             CC                    MM                                                MM                                          MM                CC            SS      
[  i  ]               SS                          CC                                                                                            GG    GGGG                                              SS      
[  i  ]                     SS  SS            CC  CC                                                              GG  MMMM                SS    GG  GG  GG      GG            SS                                
[  i  ]                                                                                                   GG              MM                SS    GGGG                    SSSS          CC  CC          GG    GG
[  i  ]                     SSSS                                                                                  GGGGMMMM                                        GG      SSSS                                  
[  i  ]                                                                                                     GG    GG                                                GG                                    GGGG  
[  i  ]     SS  SS                                                                                          CCCCCCGG                                                    GG  SS                                  
[  i  ]                                     CC  CC                                                              CC                                                                                              
[  i  ]     SS            SSSSSS              CCCC                                                                                                                                                              
[  i  ]       SS            SSSS                          MMMM                          CC                                                        CC                                      CCCC                  
[  i  ]         MMMM    GG  SSSS                                                    CC                                                                                                      CC              MMMM
[  i  ]                       SS                                                                                                              CC                                GG          CC              MMMM
[  i  ]           MMMM        SS                            MM                      GG                                                                                                                          
[  i  ]                                                                     GGGG                                                                                                  GGGG                          
[  i  ]                                                                     GG  GGGG                                                                                                    MM          GG  GG      
[  i  ]                                           GG                        GG      GG                                                                                                  MMMMMM      GG          
[  i  ]                                                                     GGGG    GG                                                                                                  MM  MMMM        GG      
[  i  ]       SS                                                                                                                                                                                    GG          
[  i  ]                                                       CCCCCC                                                                                            SS                                  GG  GG      
[  i  ]     SSGG                              GG                  CC                        MM    MM    SS                                                                                                      
[  i  ]     GGGG                                          CCCC    CC            SS                                    CC                                  CC                                                    
[  i  ] GG    GG              GG      GG                                              CC                          CC      CCCCCCCC                      SS  SS                                                  
[  i  ]                             GGGG                                CCCCSSSS      CC                      CC          CCCC    CC                                                                            
[  i  ] CCCC  GG              GG    GG            CC    GG                CCCC          CC                                        CC                            CC      CC                                      
[  i  ]   GG    GGGG  GG                          CCCC                        CC  GG  GGCCCC              CCCC            CCCC  CC                  SS          CC  CC  CC                                      
[  i  ]           GGGG                              CCGGGG                    CCCCGG  CC                                  CC                CC      SS          CC      CC        MMMM                          
[  i  ]         GG  GG                                                  CC      CC    GG                                                  CC                      CCCC              MM  MM                      
[  i  ]       GG      GG                                                SS  SS                                      MMMM    SS        CC    CCCC                    CCCC                MM                      
[  i  ]           GG                                                    SS                                  MMMMMM  MMMM        SS                                          GG  GG                              
[  i  ]                                         MM  MM                  SSSS                        SS        MM    MMMM  MMMM          CCCC                            GG    GG                                
[  i  ]                                                                     SS                        SS            MMMMMMMMMM                                                GGGG                              
[  i  ]                               CC  CC      MM                                                SSSS    SS        MM                                                GG    GG                                
[  i  ]                             GGCC            MM                          SS                  SS  SS          MM                                                          GG                              
[  i  ] MM    MM                    CC                                                            SSSSSS                                                                                        CCCC            
[  i  ]   MM                                                    MM  MM                                                                                                        MM              CC                
[  i  ] MM  MM                                                    MMMM          CC                          MM                                                                    MM            CCCC            
[  i  ]                                                         MM  MM              CC                        MM                                                                  SS                            
[  i  ]                                                                                   SS                  MM                                                                                                
[  i  ]                             SS  SSSS                                                                        CC          GG                                                  SS                          
[  i  ]                                 SSSS                                                                                        CC  CC                  CC                                                  
[  i  ]                         MM  SS      SS                CC                                                                      CCCC                CC                            MM  MM                  
[  i  ]                             MMSS    SS          GG  GG                                      GG                                CC  MM                CC                          MM                      
[  i  ] MM                          SSSS  SSSS          GGGG    CC                                    GG                                CC              CC  CC                            MMMM                  
[  i  ] MM                                              GG  CC  CC                                    GG                          MM  CC                CC            MM                GG                      
[  i  ]                                                     CCCC                                                                                                        MM                  GG                  
[  i  ]                                                                                                                                                           MM  MM                  GG    GG              
[  i  ]                       MM                                                                                                                                MM    MMMM                GGGG                  
[  i  ]                                                                                                                                                         MMMMMMMM                GGGGGG                  
[  i  ] Exiting from level generator